{
    "A": "𒍡",
    "B": "𒀞",
    "C": "𒈶",
    "D": "𒅳",
    "E": "𒇖",
    "F": "𒂬",
    "G": "𒃕",
    "H": "𒊖",
    "I": "𒇂",
    "J": "𒅍",
    "K": "𒋺",
    "L": "𒈈",
    "M": "𒀦",
    "N": "𒂄",
    "O": "𒌃",
    "P": "𒃄",
    "Q": "𒅩",
    "R": "𒀭",
    "S": "𒊻",
    "T": "𒌕",
    "U": "𒄅",
    "V": "𒅗",
    "W": "𒂑",
    "X": "𒋼",
    "Y": "𒆓",
    "Z": "𒌾",
    "a": "𒊕",
    "b": "𒅋",
    "c": "𒂡",
    "d": "𒍢",
    "e": "𒎂",
    "f": "𒌒",
    "g": "𒃖",
    "h": "𒄛",
    "i": "𒎃",
    "j": "𒈫",
    "k": "𒅷",
    "l": "𒄌",
    "m": "𒇧",
    "n": "𒌠",
    "o": "𒌛",
    "p": "𒊩",
    "q": "𒋛",
    "r": "𒊦",
    "s": "𒅹",
    "t": "𒇟",
    "u": "𒁗",
    "v": "𒃗",
    "w": "𒈬",
    "x": "𒈗",
    "y": "𒍒",
    "z": "𒎖",
    "0": "𒇊",
    "1": "𒈯",
    "2": "𒉟",
    "3": "𒇶",
    "4": "𒆂",
    "5": "𒇀",
    "6": "𒍮",
    "7": "𒍿",
    "8": "𒆡",
    "9": "𒍉",
    "!": "𒋞",
    "\"": "𒅆",
    "#": "𒌿",
    "$": "𒇃",
    "%": "𒁴",
    "&": "𒎑",
    "'": "𒇘",
    "(": "𒂏",
    ")": "𒀏",
    "*": "𒀅",
    "+": "𒁷",
    ",": "𒈞",
    "-": "𒌓",
    ".": "𒄪",
    "/": "𒇇",
    ":": "𒁥",
    ";": "𒃞",
    "<": "𒌫",
    "=": "𒌆",
    ">": "𒌷",
    "?": "𒍛",
    "@": "𒊡",
    "[": "𒆈",
    "\\": "𒋇",
    "]": "𒎊",
    "^": "𒍓",
    "_": "𒃛",
    "`": "𒌄",
    "{": "𒄘",
    "|": "𒀟",
    "}": "𒆚",
    "~": "𒁹",
    " ": "𒋑",
    "\t": "𒇗",
    "\n": "𒌁",
    "\r": "𒉕",
    "\u000b": "𒊃",
    "\f": "𒇓"
}