{
    "A": "𒊋",
    "B": "𒃳",
    "C": "𒊞",
    "D": "𒈃",
    "E": "𒃙",
    "F": "𒃮",
    "G": "𒍹",
    "H": "𒈲",
    "I": "𒊬",
    "J": "𒎓",
    "K": "𒍕",
    "L": "𒋓",
    "M": "𒄮",
    "N": "𒉦",
    "O": "𒁨",
    "P": "𒍰",
    "Q": "𒃑",
    "R": "𒅘",
    "S": "𒊏",
    "T": "𒍜",
    "U": "𒂽",
    "V": "𒈚",
    "W": "𒄈",
    "X": "𒍱",
    "Y": "𒍮",
    "Z": "𒆂",
    "a": "𒂦",
    "b": "𒆈",
    "c": "𒍑",
    "d": "𒇅",
    "e": "𒄰",
    "f": "𒅶",
    "g": "𒃰",
    "h": "𒄍",
    "i": "𒅏",
    "j": "𒋷",
    "k": "𒆴",
    "l": "𒄠",
    "m": "𒌦",
    "n": "𒇴",
    "o": "𒀼",
    "p": "𒋢",
    "q": "𒆱",
    "r": "𒄩",
    "s": "𒅭",
    "t": "𒉘",
    "u": "𒊪",
    "v": "𒉳",
    "w": "𒉁",
    "x": "𒃼",
    "y": "𒁎",
    "z": "𒈝",
    "0": "𒁁",
    "1": "𒌎",
    "2": "𒈩",
    "3": "𒂔",
    "4": "𒃣",
    "5": "𒁩",
    "6": "𒊈",
    "7": "𒊟",
    "8": "𒁰",
    "9": "𒍚",
    "!": "𒈫",
    "\"": "𒊮",
    "#": "𒎔",
    "$": "𒊢",
    "%": "𒎌",
    "&": "𒎗",
    "'": "𒍩",
    "(": "𒍊",
    ")": "𒅊",
    "*": "𒊔",
    "+": "𒃍",
    ",": "𒌜",
    "-": "𒍀",
    ".": "𒈪",
    "/": "𒋌",
    ":": "𒅮",
    ";": "𒂨",
    "<": "𒅞",
    "=": "𒀢",
    ">": "𒅐",
    "?": "𒇃",
    "@": "𒌨",
    "[": "𒌋",
    "\\": "𒃕",
    "]": "𒄔",
    "^": "𒄵",
    "_": "𒇨",
    "`": "𒀉",
    "{": "𒈾",
    "|": "𒊾",
    "}": "𒀧",
    "~": "𒂀",
    " ": "𒇆",
    "\t": "𒁫",
    "\n": "𒉈",
    "\r": "𒍨",
    "\u000b": "𒂊",
    "\f": "𒈹"
}